Type,Product,Started Date,Completed Date,Description,Amount,Fee,Currency,State,Balance
CARD_PAYMENT,Current,2025-06-08 20:18:58,2025-06-09 11:58:22,Shop,-13.27,0.00,EUR,COMPLETED,19.79
CARD_PAYMENT,Current,2025-06-10 20:18:58,2025-06-11 11:58:22,Groceries,50.50,0.00,EUR,COMPLETED,70.29
CARD_PAYMENT,Current,2025-06-12 20:18:58,2025-06-13 11:58:22,Tickets,200.00,0.00,EUR,COMPLETED,270.29
CARD_PAYMENT,Current,2025-06-13 20:18:58,2025-06-14 11:58:22,Game Stop,-100.60,0.00,EUR,COMPLETED,169.69
CARD_PAYMENT,Current,2025-06-14 20:18:58,2025-06-15 11:58:22,Amazon,450.00,0.00,EUR,COMPLETED,619.69
CARD_PAYMENT,Current,2025-06-16 20:18:58,2025-06-17 11:58:22,Samsung,-299.99,0.00,EUR,COMPLETED,319.7